WWWW3WWWWW
W g   g  W
W  B  G  W
W  g     W
W   ttT  W
W g tt   W
W   tt S W
W T tt   W
W g   G  W
WWWWW2WWWW