WWWW1WWWWW
W        W
W   g B  W
W B      W
W T   B  W
W      W W
W  G   WtW
W   t  W W
W g    W 2
WWWWWWWWWW