WWWW1WWWWW
W    B g W
W  S     W
WWWWW    W
W   W    W
W   W  WWW
W  h  t  W
W      g W
W  g   T W
WWWWWWWWWW