WWWW1WWWWW
WS   G   W
W  T     W
W t   g SW
W   S    W
W  g   W W
W    B WtW
W   WWWW W
W   W  t W
WWWWW2WWWW